##############################
#E#    # # # #     # #    # ##
# # ##        ## ##  # ##    #
# #  #### # #    #  ##   ### #
#  #     #  # ## # #   #   # #
##  ## #  #  #      # # # ## #
# #  ##  # #  ### # # #  #   #
#   #   #  # #   # #   # # ###
# #   #   #    #     #   #  S#
##############################
